&.&.....&&.
...&&&&&...
....&......
....&&&&&&.
.........@.
#.&&&&&&&&&
